NO    ./textures/north.xpm
SO    ./textures/south.xpm
WE    ./textures/west.xpm
EA    ./textures/east.xpm

F   255,128,0
C   0,64,128

1111111
1000001
1011101
100N001
1011101
1000001
1111111
