
1111111111
1000000001
10N0020001
1000000001
1002000001
1111111111
