
1111111111
1000000001
100N00D001
1000000001
1000000001
1111111111
