11111111111
1000000001
1  1100N001
1  1000001
1  1111111
10000001
10002001
11111111
