111111111111111
100000000000001
10N00111100D001
100001000000001
1000010000D0001
100001000000001
10000100002D001
100000000000001
111111111111111
