F 10,20,5
C 100,100,100

EA ./textures/east.png
NO ./textures/north.png
SO ./textures/south.png
WE ./textures/west.png

111111111
100000001
100111001
100100001
1001E0001
100111001
100000001
111111111
