NO ./textures/north.xpm
SO ./textures/south.xpm
WE ./textures/west.xpm
EA ./textures/east.xpm

F 0,128,255
C 50,50,50

1111111111
1000000001
1011111001
1010001001
1010001001
101S001001
1011111001
1000000001
1111111111
