NO ./textures/north.png
SO ./textures/south.png
WE ./textures/west.png
EA ./textures/east.png

F 128,0,255
C 255,200,0

111111111111111
100000000000001
111111101111111
      101
      101
      1W1
      111
