NO ./textures/north.png
SO ./textures/south.png
WE ./textures/west.png
EA ./textures/east.png

F              2, 100,0
C 225,30,0

111111
10D001
110D11
100N01
100001
111111
