NO ./textures/north.png
SO ./textures/south.png
WE ./textures/west.png
EA ./textures/east.png

F 60,60,60
C 200,200,200

111111111111111
100000000000001
101111111111001
101000000001001
101011111001001
101010000001001
1010101111E1001
101010000001001
101011111111001
101000000001001
101111111111001
100000000000001
111111111111111
